10000000000
02220202020
00020202000
22020202022
00000002000
02222222220
00000000000
22220202222
00000230000
02220222220
00000000000
