10000000
02022202
00000000
02020220
00023000
