10000002000
02020222020
02020000000
02022202220
00000000023
